Movie=Movie
Television=TV show
M-TiCl=Timeless Classics
M-Ac=Action
M-Co=Comedy
M-Dr=Drama
M-Ho=Horror
M-Cr=Crime
M-Do=Documentaries
M-TiCl-Sc=Scientists create a cannon to send them to the moon
M-TiCl-La=A lawyer defends an innocent black man in the 1930's south
M-TiCl-Ge=A German expressionist film where an upper class man leads the lower class in revolt
M-Ac-MaAr=Martial Arts
M-Ac-Se=Serious
M-Ac-Go=Goofy
M-Co-CoBr=Coen Brothers
M-Co-Ta=Tarantino
M-Co-An=Animated
M-Co-LiAc=Live Action
M-Dr-NeNo=Neo-Noir
M-Dr-Cu=Cute
M-Dr-PoBi=Political biopic
M-Ho-CuHo=Cult Horror
M-Ho-ClHo=Classic Horror
M-Ho-CoHo=Contemporary Horror
M-Cr-Ac=Action
M-Cr-My=Mystery
M-Cr-SoDi=Something different
M-Do-In=An inside look into the amateur porn industry
M-Do-No=Noam Chomsky looks at wealth inequality in America
M-Do-Dr=A story of drug dealers in 1980's Florida
M-Do-St=A study of German Expressionist cinema and fascism
M-Ac-MaAr-Re=Realistic
M-Ac-MaAr-Ta=Tarantino directed revenge movie
M-Ac-MaAr-Sp=Special effects out the wazoo
M-Ac-Se-Co=Comic book based
M-Ac-Se-ScFi=Sci-fi
M-Ac-Go-Br=British
M-Ac-Go-NoBr=Not British
M-Co-CoBr-Gr=Greatest thing to happen to this earth. Go buy it on Amazon
M-Co-CoBr-Od=The Odyssey set in the depression era south
M-Co-CoBr-Mi=Minnesotan banker tries to ransom his own wife
M-Co-An-Ad=Adorable and underrated
M-Co-An-SeFu=Semi-funny trash
M-Co-LiAc-So=Something fucked up
M-Co-LiAc-Ho=Horror
M-Co-LiAc-Po=Political
M-Co-LiAc-We=Weird
M-Co-LiAc-Cl=Classics
M-Dr-NeNo-Ke=Kevin Spacey relays his story of a robbery gone south
M-Dr-NeNo-Ir=Iran's first vampire/gangster/western/horror movie
M-Dr-NeNo-Ch=Christopher Nolan directed movie about stalkers
M-Dr-Cu-Te=Teenager starts seeing his dead brother
M-Dr-Cu-Fr=French movie about a girl's first lesbian relationship
M-Dr-Cu-We=Wes Anderson movie about two kids running away from home
M-Dr-PoBi-Ww=WW2 General Patton. "Rommel, you magnificent bastard! I read your book!"
M-Dr-PoBi-Ji=Jimmy Hoffa, union leader and mob boss who died under mysterious circumstances
M-Dr-PoBi-Ce=Cecil Gaines (fictionalised version of Eugene Allen) is a White House butler for 8 presidents
M-Dr-PoBi-Do=Doctor, General, Revelutionary Che Guevara
M-Ho-CuHo-Ex=Extremely gory movie about sadists from another dimension
M-Ho-CuHo-Ha=A haunted house tortures its family
M-Ho-ClHo-So=Some scientists hunt for a shark
M-Ho-ClHo-Co=A couple stumbles upon a strange town with no adults
M-Ho-CoHo-De=A deaf-mute is trapped in her house by a masked killer
M-Ho-CoHo-Sp=A spooky children's character comes to life and terrorises a mother
M-Cr-Ac-Ma=A man locked in a mysterious room for many years is suddenly freed
M-Cr-Ac-Co=Coen Brothers' movie about a hitman who chases bystander after a drug deal gone bad
M-Cr-Ac-Jo=John Woo directed movie where a hitman takes job to help woman he accidentally injured
M-Cr-My-Fa=Father hunts his daughter's killer, while the daughter's ghost watches
M-Cr-My-Jo=Journalist works with hacker to find a wealthy girl
M-Cr-SoDi-Ma=Man videotapes a sells footage of crime scenes
M-Cr-SoDi-Jo=Journalists investigate pedophilia in the catholic church
M-Ac-Se-Co-No=Film Noir
M-Ac-Se-Co-Ro=Ron Perlman in a shit ton of makeup
M-Ac-Se-ScFi-Cy=Cyberpunk cop in a huge city
M-Ac-Se-ScFi-As=Asteroid apocalypse
M-Ac-Go-NoBr-Ho=Homage to the 80's
M-Ac-Go-NoBr-Ac=Actually from the 80's
M-Ac-Go-NoBr-Ta=Tarantino directed movie about people killing Nazis
M-Co-LiAc-So-Lo=A lot
M-Co-LiAc-So-Li=A little
M-Co-LiAc-Ho-Ki=Just kinda weird
M-Co-LiAc-Ho-Sh=Shitty 80's horror at its peak
M-Co-LiAc-Ho-Pl=Just plain stupid
M-Co-LiAc-We-Ma=Man in a paper mache mask
M-Co-LiAc-We-Hi=Hitler time travelling
M-Co-LiAc-Cl-Go=A good one
M-Co-LiAc-Cl-Sh=A shitty one
M-Co-LiAc-Cl-Cu=Cult classics
M-Co-LiAc-Cl-Sh-Se=Sexy
M-Co-LiAc-Cl-Sh-No=Not sexy
M-Co-LiAc-Cl-Cu-Pl=Teenager playing hooky in downtown Chicago
M-Co-LiAc-Cl-Cu-Ta=Teenager takes clique drama to the next level
M-Co-LiAc-Cl-Cu-St=70's stoners
M-Co-LiAc-Cl-Cu-Hi=Hilarious low budget independent comedy
M-Co-LiAc-Cl-Cu-Sa=Satire of fantasy tropes
M-Co-LiAc-Cl-Cu-Ta-Ki=Killing people next level
M-Co-LiAc-Cl-Cu-Ta-Se=Sending candygrams level
T-Co=Comedy
T-Ac=Action
T-Dr=Drama
T-Co-LiAc=Live Action
T-Co-An=Animated
T-Ac-LiAc=Live Action
T-Ac-An=Anime
T-Dr-Cr=Crime
T-Dr-Mi=Mindfuckery
T-Dr-No=None of the above?
T-Co-LiAc-Wo=Workplace comedy
T-Co-LiAc-Fa=Family based comedy
T-Co-LiAc-Fr=Friends hanging out
T-Co-An-Ad=Adult
T-Co-An-Ch=Children
T-Ac-LiAc-Dc=DC
T-Ac-LiAc-Ma=Marvel
T-Ac-LiAc-ScFi=Sci-fi & Fantasy
T-Ac-An-Hi=A high-schooler finds a book that kills anyone whose name is in it
T-Ac-An-Am=American anime about girls going to school to fight monsters
T-Ac-An-Ja=Japanese schoolgirl gets sent to Japan with a demon
T-Ac-An-So=The son of Satan decides to fight demons as an exorcist
T-Ac-An-Co=A country kid moves to Tokyo and becomes involved with the local street politics
T-Dr-Cr-Go=Good Guys
T-Dr-Cr-Ba=Bad Guys
T-Dr-Mi-Cl=Classic sci-fi serial featuring short, ponderous stories
T-Dr-Mi-Mo=Modern Twilight Zone with an emphasis on technology
T-Dr-Mi-Su=Surreal 90's mustery produced by David Lynch
T-Dr-No-Ki=Kids lose their friend to an uneathly creature and track him down
T-Dr-No-Ba=Backstabbing senator claws his way through politics
T-Co-LiAc-Wo-Am=American
T-Co-LiAc-Wo-Br=British
T-Co-LiAc-Fa-Su=A suburban middle child growing up
T-Co-LiAc-Fa-Ri=A rick family deals with their wealth falling apart
T-Co-LiAc-Fr-St=70's stoners
T-Co-LiAc-Fr-Ma=A man tells his children about his various youthful exploits
T-Co-LiAc-Fr-Ex=An ex-cult member goes to New York and tries to make it
T-Co-An-Ad-Ol=Old school Halo machinima
T-Co-An-Ad-Pa=Parody of the super-spy genre
T-Co-An-Ad-Ve=Very unlucky family tries to keep their burger joint in shape
T-Co-An-Ch-Ch=Chaotic toons do shenanigans
T-Co-An-Ch-Cl=Cleverly written show featuring two young geniuses building contraptions
T-Ac-LiAc-Dc-Ba=If Batman fought with bows
T-Ac-LiAc-Dc-Gu=Guy goes fast
T-Ac-LiAc-Ma-Su=Super strong detective with traumatic past
T-Ac-LiAc-Ma-Bl=Blind lawyer fights crime with his super senses
T-Ac-LiAc-Ma-Ex=Ex-con cleans up Harlem from local ganglords
T-Ac-LiAc-ScFi-ScFi=Sci-fi
T-Ac-LiAc-ScFi-Fa=Fantasy
T-Dr-Cr-Go-Mo=Modern British Sherlock Holmes
T-Dr-Cr-Go-Fb=FBI detectives tracking serial killers
T-Dr-Cr-Ba-Ca=Cartel
T-Dr-Cr-Ba-Bi=Biker Gang
T-Dr-Cr-Ba-Me=Meth Cooks
T-Co-LiAc-Wo-Am-On=One man comedy writing team
T-Co-LiAc-Wo-Am-Tw=Two best friends work at a hospital
T-Co-LiAc-Wo-Am-Pu=Pub owners get caught in various antics
T-Co-LiAc-Wo-Am-Lo=Loval government
T-Co-LiAc-Wo-Am-Re=Relatable story of dysfunctional workplaces
T-Co-LiAc-Wo-Br-Re=Relatable story of dysfunctional workplaces
T-Co-LiAc-Wo-Br-So=Socially awkward IT specialists
T-Ac-LiAc-ScFi-ScFi-Su=Superhero-esque mutants fight crime
T-Ac-LiAc-ScFi-ScFi-Nu=Nuclear apocalypse?
T-Ac-LiAc-ScFi-ScFi-Pe=People fight crime with help of pervasive surveillance
T-Ac-LiAc-ScFi-Fa-Tw=Two brothers hunt monsters and demons
T-Ac-LiAc-ScFi-Fa-Mu=Musical fairy tale satire
T-Ac-LiAc-ScFi-Fa-Re=A retelling of Arthurian legend
T-Ac-LiAc-ScFi-ScFi-Nu-Ge=Surviving generations after apocalypse
T-Ac-LiAc-ScFi-ScFi-Nu-Im=Surviving immediately after apocalypse
Next=Next
Prev=Prev
Restart=Restart
WelcomeMessage=Can't decide what to watch?! We'll guide you. Let's start!
StartQuestion=Do you prefer Movie or TV show?
dis-M=Movie selected. Choose main category:
dis-T=TV show selected. Choose main category:
dis-M-TiCl=Timeless Classics selected. Choose movie topic:
dis-M-Ac=Action selected. Choose subcategory:
dis-M-Co=Comedy selected. Choose subcategory:
dis-M-Dr=Drama selected. Choose subcategory:
dis-M-Ho=Horror selected. Choose subcategory:
dis-M-Cr=Crime selected. Choose subcategory:
dis-M-Do=Documentaries selected. Choose movie topic:
dis-M-Ac-MaAr=Martial Arts selected. Choose movie topic:
dis-M-Ac-Se=Serious selected. Choose subcategory:
dis-M-Ac-Go=Goofy selected. Choose subcategory:
dis-M-Co-CoBr=Coen Brothers selected. Choose movie topic:
dis-M-Co-An=Animated selected. Choose movie topic:
dis-M-Co-LiAc=Live Action selected. Choose subcategory:
dis-M-Dr-NeNo=Neo-Noir selected. Choose movie topic:
dis-M-Dr-Cu=Cute selected. Choose movie topic:
dis-M-Dr-PoBi=Political biopic selected. Choose movie topic:
dis-M-Ho-CuHo=Cult Horror selected. Choose movie topic:
dis-M-Ho-ClHo=Classic Horror selected. Choose movie topic:
dis-M-Ho-CoHo=Contemporary Horror selected. Choose movie topic:
dis-M-Cr-Ac=Action selected. Choose movie topic:
dis-M-Cr-My=Mystery selected. Choose movie topic:
dis-M-Cr-SoDi=Something different selected. Choose movie topic:
dis-M-Ac-Se-Co=Comic Book Based selected. Choose movie topic:
dis-M-Ac-Se-ScFi=Sci-fi selected. Choose movie topic:
dis-M-Ac-Go-NoBr=Not British selected. Choose movie topic:
dis-M-Co-LiAc-So=Something fucked up selected. Choose movie topic:
dis-M-Co-LiAc-Ho=Horror selected. Choose movie topic:
dis-M-Co-LiAc-We=Weird selected. Choose movie topic:
dis-M-Co-LiAc-Cl=Classics selected. Choose subcategory:
dis-M-Co-LiAc-Cl-Sh=A shitty one selected. Choose movie topic:
dis-M-Co-LiAc-Cl-Cu=Cultclassics selected. Choose movie topic:
dis-M-Co-LiAc-Cl-Cu-Ta=Teenager takes clique drama to the next level selected. Choose specific topic:
dis-T-Co=Comedy selected. Choose subcategory:
dis-T-Ac=Action selected. Choose subcategory:
dis-T-Dr=Drama selected. Choose subcategory:
dis-T-Co-LiAc=Live Action selected. Choose subcategory:
dis-T-Co-An=Animated selected. Choose subcategory:
dis-T-Ac-LiAc=Live Action selected. Choose subcategory:
dis-T-Ac-An=Anime selected. Choose TV show topic:
dis-T-Dr-Cr=Crime selected. Choose subcategory:
dis-T-Dr-Mi=Mindfuckery selected. Choose TV show topic:
dis-T-Dr-No=None of the above? selected. Choose TV show topic:
dis-T-Co-LiAc-Wo=Workplace comedy selected. Choose subcategory:
dis-T-Co-LiAc-Fa=Family Based Comedy selected. Choose TV show topic:
dis-T-Co-LiAc-Fr=Friends Hanging Out selected. Choose TV show topic:
dis-T-Co-An-Ad=Adult selected. Choose TV show topic:
dis-T-Co-An-Ch=Children selected. Choose TV show topic:
dis-T-Ac-LiAc-Dc=DC selected. Choose TV show topic:
dis-T-Ac-LiAc-Ma=Marvel selected. Choose TV show topic:
dis-T-Ac-LiAc-ScFi=Sci-fi & Fantasy selected. Choose subcategory:
dis-T-Dr-Cr-Go=Good Guys selected. Choose TV show topic:
dis-T-Dr-Cr-Ba=Bad Guys selected. Choose TV show topic:
dis-T-Co-LiAc-Wo-Am=American selected. Choose TV show topic:
dis-T-Co-LiAc-Wo-Br=British selected. Choose TV show topic:
dis-T-Ac-LiAc-ScFi-ScFi=Sci-fi selected. Choose TV show topic:
dis-T-Ac-LiAc-ScFi-Fa=Fantasy selected. Choose TV show topic:
dis-T-Ac-LiAc-ScFi-ScFi-Nu=Nuclear Apocalipse? selected. Choose specific topic:
film-M-TiCl-Sc=Your movie is - A Trip to the Moon
film-M-TiCl-La=Your movie is - To Kill a Mockingbird
film-M-TiCl-Ge=Your movie is - Metropolis
film-M-Ac-MaAr-Re=Your movie is - Way of the Dragon
film-M-Ac-MaAr-Ta=Your movie is - Kill Bill Vol.1 or Kill Bill Vol.2
film-M-Ac-MaAr-Sp=Your movie is - The Five Venoms
film-M-Ac-Se-Co-No=Your movie is - Sin City
film-M-Ac-Se-Co-Ro=Your movie is - Hellboy
film-M-Ac-Se-ScFi-Cy=Your movie is - Judge Dredd
film-M-Ac-Se-ScFi-As=Your movie is - Armageddon
film-M-Ac-Go-Br=Your movie is - Hot Fuzz
film-M-Ac-Go-NoBr-Ho=Your movie is - Kung Fury
film-M-Ac-Go-NoBr-Ac=Your movie is - Big Trouble in Little China
film-M-Ac-Go-NoBr-Ta=Your movie is - Inglorious Basterds
film-M-Co-CoBr-Gr=Your movie is - The Big Lebowski
film-M-Co-CoBr-Od=Your movie is - Oh Brother, Where Art Thou
film-M-Co-CoBr-Mi=Your movie is - Fargo
film-M-Co-Ta=Your movie is - Pulp fiction
film-M-Co-An-Ad=Your movie is - Home
film-M-Co-An-SeFu=Your movie is - South Park: Bigger, Longer and Uncut
film-M-Co-LiAc-So-Lo=Your movie is - Trainspotting
film-M-Co-LiAc-So-Li=Your movie is - Pee-Wee's Big Adventure
film-M-Co-LiAc-Ho-Ki=Your movie is - Human Centipede
film-M-Co-LiAc-Ho-Sh=Your movie is - ReAnimator
film-M-Co-LiAc-Ho-Pl=Your movie is - Tucker and Dale vs. Evil
film-M-Co-LiAc-Po=Your movie is - Bulworth
film-M-Co-LiAc-We-Ma=Your movie is - Frank
film-M-Co-LiAc-We-Hi=Your movie is - Look Who's Back
film-M-Co-LiAc-Cl-Go=Your movie is - Grease
film-M-Co-LiAc-Cl-Sh-Se=Your movie is - Barbarella
film-M-Co-LiAc-Cl-Sh-No=Your movie is - Animal House
film-M-Co-LiAc-Cl-Cu-Pl=Your movie is - Ferris Bueller's Day Off
film-M-Co-LiAc-Cl-Cu-Ta-Ki=Your movie is - Heathers
film-M-Co-LiAc-Cl-Cu-Ta-Se=Your movie is - Mean Girls
film-M-Co-LiAc-Cl-Cu-St=Your movie is - Dazed and Confused
film-M-Co-LiAc-Cl-Cu-Hi=Your movie is - Clerks
film-M-Co-LiAc-Cl-Cu-Sa=Your movie is - The Princess Bride
film-M-Dr-NeNo-Ke=Your movie is - The Usual Suspects
film-M-Dr-NeNo-Ir=Your movie is - A Girl Walks Home Alone at Night
film-M-Dr-NeNo-Ch=Your movie is - Following
film-M-Dr-Cu-Te=Your movie is - Charlie St. Cloud
film-M-Dr-Cu-Fr=Your movie is - Blue is the Warmest Color
film-M-Dr-Cu-We=Your movie is - Moonrise Kingdom
film-M-Dr-PoBi-Ww=Your movie is - Patton
film-M-Dr-PoBi-Ji=Your movie is - Hoffa
film-M-Dr-PoBi-Ce=Your movie is - The Butler
film-M-Dr-PoBi-Do=Your movie is - Che
film-M-Ho-CuHo-Ex=Your movie is - Hellraiser
film-M-Ho-CuHo-Ha=Your movie is - The Amityville Horror
film-M-Ho-ClHo-So=Your movie is - Jaws
film-M-Ho-ClHo-Co=Your movie is - Children of the Corn
film-M-Ho-CoHo-De=Your movie is - Hush
film-M-Ho-CoHo-Sp=Your movie is - The Babadook
film-M-Cr-Ac-Ma=Your movie is - Oldboy
film-M-Cr-Ac-Co=Your movie is - No Country for Old Men
film-M-Cr-Ac-Jo=Your movie is - The Killer
film-M-Cr-My-Fa=Your movie is - The Lovely Bones
film-M-Cr-My-Jo=Your movie is - The Girl with the Dragon Tattoo
film-M-Cr-SoDi-Ma=Your movie is - Nightcrawler
film-M-Cr-SoDi-Jo=Your movie is - Spotlight
film-M-Do-In=Your movie is - Hot Girls Wanted
film-M-Do-No=Your movie is - Requiem for the American Dream
film-M-Do-Dr=Your movie is - Cocaine Cowboys
film-M-Do-St=Your movie is - From Caligari to Hitler
film-T-Co-LiAc-Wo-Am-On=Your TV show is - 30 Rock
film-T-Co-LiAc-Wo-Am-Tw=Your TV show is - Scrubs
film-T-Co-LiAc-Wo-Am-Pu=Your TV show is - It's Always Sunny in Philadelphia
film-T-Co-LiAc-Wo-Am-Lo=Your TV show is - Parls and Rec
film-T-Co-LiAc-Wo-Am-Re=Your TV show is - The Office (US)
film-T-Co-LiAc-Wo-Br-Re=Your TV show is - The Office (UK)
film-T-Co-LiAc-Wo-Br-So=Your TV show is - The IT Crowd
film-T-Co-LiAc-Fa-Su=Your TV show is - Malcolm in the Middle
film-T-Co-LiAc-Fa-Ri=Your TV show is - Arrested Development
film-T-Co-LiAc-Fr-St=Your TV show is - That 70's Show
film-T-Co-LiAc-Fr-Ma=Your TV show is - How I Met Your Mother
film-T-Co-LiAc-Fr-Ex=Your TV show is - Unbreakable Kimmy Schmidt
film-T-Co-An-Ad-Ol=Your TV show is - Red vs. Blue
film-T-Co-An-Ad-Pa=Your TV show is - Archer
film-T-Co-An-Ad-Ve=Your TV show is - Bob's Burgers
film-T-Co-An-Ch-Ch=Your TV show is - Pokemon
film-T-Co-An-Ch-Cl=Your TV show is - Phineas and Ferb
film-T-Ac-LiAc-Dc-Ba=Your TV show is - Arrow
film-T-Ac-LiAc-Dc-Gu=Your TV show is - The Flash
film-T-Ac-LiAc-Ma-Su=Your TV show is - Jessica Jones
film-T-Ac-LiAc-Ma-Bl=Your TV show is - Daredevil
film-T-Ac-LiAc-Ma-Ex=Your TV show is - Luke Cage
film-T-Ac-LiAc-ScFi-ScFi-Su=Your TV show is - Alphas
film-T-Ac-LiAc-ScFi-ScFi-Nu-Ge=Your TV show is - The 100
film-T-Ac-LiAc-ScFi-ScFi-Nu-Im=Your TV show is - Jericho
film-T-Ac-LiAc-ScFi-ScFi-Pe=Your TV show is - Person of Interest
film-T-Ac-LiAc-ScFi-Fa-Tw=Your TV show is - Supernatural
film-T-Ac-LiAc-ScFi-Fa-Mu=Your TV show is - Galavant
film-T-Ac-LiAc-ScFi-Fa-Re=Your TV show is - Merlin
film-T-Ac-An-Hi=Your TV show is - Death Note
film-T-Ac-An-Am=Your TV show is - RWBY
film-T-Ac-An-Ja=Your TV show is - Inuyasha
film-T-Ac-An-So=Your TV show is - Blue Exorcist
film-T-Ac-An-Co=Your TV show is - Durarara
film-T-Dr-Cr-Go-Mo=Your TV show is - Sherlock
film-T-Dr-Cr-Go-Fb=Your TV show is - Criminal Minds
film-T-Dr-Cr-Ba-Ca=Your TV show is - Narcos
film-T-Dr-Cr-Ba-Bi=Your TV show is - Sons of Anarchy
film-T-Dr-Cr-Ba-Me=Your TV show is - Breaking Bad
film-T-Dr-Mi-Cl=Your TV show is - The Twilight Zone
film-T-Dr-Mi-Mo=Your TV show is - Black Mirror
film-T-Dr-Mi-Su=Your TV show is - Twin Peaks
film-T-Dr-No-Ki=Your TV show is - Stranger Things
film-T-Dr-No-Ba=Your TV show is - House of Cards